#########################
#S                      #
####################### #
#                       #
# #######################
#                       #
####################### #
#                       #
# #######################
#                       #
####################### #
#                       #
# #######################
#                       #
####################### #
#                       #
# #######################
#                       #
####################### #
#                       #
# #######################
#                       #
####################### #
#                      E#
#########################
