#########################
#S                      #
# # # # # # # # # # # # #
# # # # # # # # # # # # #
# # # # # # # # # # # # #
# # # # # # # # # # # # #
# # # # # # # # # # # # #
# # # # # # # # # # # # #
# # # # # # # # # # # # #
# # # # # # # # # # # # #
# # # # # # # # # # # # #
# # # # # # # # # # # # #
# # # # # # # # # # # # #
# # # # # # # # # # # # #
# # # # # # # # # # # # #
# # # # # # # # # # # # #
# # # # # # # # # # # # #
# # # # # # # # # # # # #
# # # # # # # # # # # # #
# # # # # # # # # # # # #
# # # # # # # # # # # # #
# # # # # # # # # # # # #
# # # # # # # # # # # # #
#E#######################
#########################
