#########################
#S                      #
# ##################### #
# #                   # #
# # ################# # #
# #                 #   #
# #######################
#                       #
# ##################### #
# #                   # #
# # ################# # #
# #                 #   #
# #######################
#                       #
# ##################### #
# #                   # #
# # ################# # #
# #                 #   #
# #######################
#                       #
# ##################### #
# #                   # #
# # ################# # #
#E#                 #   #
#########################
